---TEXTURES
# 7.0f0 "./res/land_dirt05.png"
+ 1.0f0 "./res/Tiles/Asphalt road/road_asphalt01.png"
---MAP
#####################
#####################
##+++++++++++++++++##
##+++++++++++++++++##
##+++++++++++++++++##
##+++++++++++++++++##
##++++#########++++##
##++++#########++++##
##++++#########++++##
##++++#########++++##
##+++++++++++++++++##
##+++++++++++++++++##
##+++++++++++++++++##
##+++++++++++++++++##
#####################
#####################
---OBJECTS
(instantiate-prototype 'camera)
(instantiate-prototype 'car (v! 200 0) (/ pi 2f0))
(instantiate-prototype 'tire)